0================================================0
|'.                    (|)                     .'|
|  '.                   |                    .'  |
|    '.                |O|                 .'    |
|      '. ____________/===\_____________ .'      |
|        :            `\"/`  ______     :     .. |
|        :     mmmmmmm  V   |--%%--|    :   .'|| |
|        :     |  |  |      |-%%%%-|    :  |  || |
|        :     |--|--| @@@  |=_||_=|    :  I  || |
|        :     |__|__|@@@@@ |_\__/_|    :  |  || |
|        :             \|/   ____       :  |  || |
|        :;;       .'``(_)```\__/````:  :  |  || |
|        :||___   :================:'|  :  | 0+| |
|        :||===)  | |              | |  :  |  || |
|        ://``\\__|_|______________|_|__:  I  || |
|      .'/'    \' | '              | '   '.|  || |
|    .'           |                |       '. || |
|  .'                                        '|| |
|.'                                            '.|
0================================================0
